NO textures/tzz2.xpm
SO textures/tzz2.xpm
WE textures/tzz2.xpm
EA textures/tzz2.xpm

F 220,100,0
C 225,30,0




        1111111111110111111111111
        1000000000110000000000001
        1011000001110000000000001
        1001000000000000000000001
111111111011000001110000000000001
100000000011000001110111111111111
11110111111111011100000010001
1110111111111011101010010001
11000000110101011100000010011
0000000000000001100000010001
10000000000000001101010010001
11000001110111011111011110N0111
11110111 111 101 101111010001
1111111 1111111 111111111111